NNNNNNNNNNNN
NNMNNNNNNFNN
NNNNNNNNNNNN
NNFNNNNNNMNN
NNNNNNNNNNNN
NNNNNNNNNNNN
NNMNNNNNNFNN
NNNNNNNNNNNN
NNFNNNNNNMNN
NNNNNNNNNNNN