GGGGGGGGGGGG
GPPPTTTTPPPG
GPGGGGGGGGPG
GPPPTTTTPPPG
GPGGGGGGGGPG
GPGGGGGGGGPG
GPPPTTTTPPPG
GPGGGGGGGGPG
GPPPTTTTPPPG
GGGGGGGGGGGG