[37,33]
18
90
{Bomb,14} {Gas,12} {MaleChange,6} {FemaleChange,6} {NoEntry,15} {Poison,6} {DeathRat,35} {Sterilisation,18}
GGGGGGGGGGGGGGGGGGGGGGGGGGGGGGGGGGGGG
GGGGGGGGGGGGGGGGGGGGGGGGGGGGGGGGGGGGG
GGGGGPFPGGGGGGGGGGGGGGGGGGGGGGGGGGGGG
GGGGGTGTGGGGGGGGGGGGGGGGGGGGGGGGGGGGG
GGGGGPGPGGGMGMGGGGGGGGGGGGGGGGGGGGGGG
GGGGGPPPGGGTGTGGGGGGGGGGGGGGGGGGGGGGG
GGGPPPGPPPGTGTGGGGGGGGGGGGGGGGGGGGGGG
GGGPGPGPGPGTGTGGGGGGGGGGGGGGGGGGGGGGG
GGGGGPPPGGGTGTPPPPPPGGGGGGGGGGGGGGGGG
GGGGGPGPGGGPPPGGGGGTGGGGGGGGGGGGGGGGG
GGGGGPGPGGGTGTGGGGGTGGGGGGGGGGGGGGGGG
GGGPPPPPPPPPPPPPPPPPPPPPPPPPPPPPPGGGG
GGGGGGGGGGGGGGNGGGGGGGGGGGGGGGTGGGGGG
GGGGGGGGGGGGGGGGGGGGGGGGGGGGGGTGGGGGG
GGGGGGGGGGGGGGKGGGGGGGGGGGGGGGTGGGGGG
GGGGGPPPPPPPPPPPPPPPPPPPPPPPPPPPPPPGG
GGGGGGGTGGGGTGGGGGGGGGGGGGGGNGGGGGGGG
GGGGGGGTGGGGTGGGGGGGGGGGGGGGGGGGGGGGG
GGGGGGGTGGGGTGGGGGGGGGGGGGGGKGGGGGGGG
GGGPPPPPPPPPPPPPPPPPPPPPPPPPPPPPPGGGG
GGGGGGGGGGGNGGGGTGGGGGGGGGGGGGTGGGGGG
GGGGGGGGGGGGGGGGTGGGGGGGGGGGGGTGGGGGG
GGGGGGGGGGGKGGGGTGGGGGGGGGGGGGTGGGGGG
GGGGGPPPPPPPPPPPPPPPPPPPPPPPPPPPPPPGG
GGGGGGGTGGGGGGTGGGGGGGGGGGGGGGGGGGGGG
GGGGGGGTGGGGGGTGGGGGGGGGGGGGGGGGGGGGG
GGGGGGGTGGGGGGTGGGGGGGGGGGGGGGGGGGGGG
GGGPPPPPPPPPPPPPPPPPPPPPPPPPPPPPPGGGG
GGGGGGGGGGGGNGGGGGGGGGGGGGGGGGTGGGGGG
GGGGGGGGGGGGGGGGGGGGGGGGGGGGGGTGGGGGG
GGGGGGGGGGGGKGGGGGGGGGGGGGGGGGTGGGGGG
GPPPPPPPPPPPPPPPPPPPPPPPPPPPPPPPPPPPG
GGGGGGGGGGGGGGGGGGGGGGGGGGGGGGGGGGGGG


