[28,26]
16
60
{Bomb,6} {Gas,10} {MaleChange,8} {FemaleChange,8} {NoEntry,12} {Poison,8} {DeathRat,26} {Sterilisation,12}
GGGGGGGGGGGGGGGGGGGGGGGGGGGG
GGGGGGGGGGGGGGGGGGGGGGGGGGGG
GGMPPPPPPPGGGGGGGGPPPPPPPMGG
GGPGGGGGGPGGGGGGGGPGGGGGGPGG
GGPGGGGGGPGGGGGGGGPGGGGGGPGG
GGPGGGGGGPGGGGGGGGPGGGGGGPGG
GGPGGGTTTPGGGGGGGGPTTTGGGPGG
GGPGGGTGGPGGGGGGGGPGGTGGGPGG
GGPGGGTGGPGGGGGGGGPGGTGGGPGG
GGPPPPPPPFGGGGGGGGFPPPPPPPGG
GGGGGGGGGPPPPPPPPPPGGGGGGGGG
GGGGGGGGGPGTGGGGTGPGGGGGGGGG
GGGGGGGGGPGTGGGGTGPGGGGGGGGG
GGGGGGGGGPGTGGGGTGPGGGGGGGGG
GGMPPPPPPPGTGGGGTGPPPPPPPFGG
GGPGTGGTGGGTGGGGTGGGTGGTGPGG
GGPGTGGTGGGTGGGGTGGGTGGTGPGG
GGPGTGGTGGGTGGGGTGGGTGGTGPGG
GGPGTGGTGPPPPPPPPPPGTGGTGPGG
GGPGTGGTGPGGGGGGGGPGTGGTGPGG
GGPGTGGTGPGGGGGGGGPGTGGTGPGG
GGPGTGGTGPGGGGGGGGPGTGGTGPGG
GGPGTGGTGPGGGGGGGGPGTGGTGPGG
GGPPPPPPPFGGGGGGGGMPPPPPPPGG
GGGGGGGGGGGGGGGGGGGGGGGGGGGG
GGGGGGGGGGGGGGGGGGGGGGGGGGGG