[20,20]
12
60
{Bomb,6} {Gas,10} {MaleChange,8} {FemaleChange,8} {NoEntry,10} {Poison,5} {DeathRat,16} {Sterilisation,12}
GGGGGGGGGGGGGGGGGGGG
GMPPPPGGGGGGGGGGGGGG
GPGGGPGGGGGGGPPPPGGG
GPGGGPGGGGGGGPGGPGGG
GPPPPFPPPPPPPPPPMGGG
GPGGPGGGGGGGGPGGGGGG
GPGGPTTTTTTTTPGGGGGG
GPGGPGGGGGGGGGGGGGGG
GPPPPPPPPPPPPPPMPTGG
GGGGPGGGGGGGGGGGGTGG
GGGGPPPPPPPPGGGGGTGG
GGGGPGGGGGGPGGGGGTGG
GGGGPGGGGGGPGGGGGTGG
GPPPPGGGGGGPPPPPPTGG
GPGGPGGGGGGPGGPGGGGG
GPGGPGGGGGGPGGPGGGGG
GMPPPTTTTTTPPPPPPPPG
GGGGGGGGGGGGGGPGGGPG
GGGGGGGGGGGGGGPPPPFG
GGGGGGGGGGGGGGGGGGGG