[40,40]
22
75
{Bomb,8} {Gas,10} {MaleChange,8} {FemaleChange,8} {NoEntry,12} {Poison,7} {DeathRat,14} {Sterilisation,12}
GGGGGGGGGGGGGGGGGGGGGGGGGGGGGGGGGGGGGGGG
GTTTPPPPPPPPPPPPPPPGGGGGGGGGGGGGGGGGGGGG
GTGGGGGGGGGGGGGGGGPGGGGGGGGGGGGGGGGGGGGG
GTGGGGGGGGGGGGGGGGPPPPPPPPPPPPPPPPPPPPPG
GPGGGGGGGGGGGGGGGGPGGGGGGGGGGGGGGGGGGGPG
GPGGGGGGGGGGGGGGGGPGGGGGGGGGGGGGGGGGGGPG
GPPPPPPPPPPPPPPPPPPPTTTTTTTPPPPPPPPPPPPG
GGGGGPGGGGGGGGGGGGGGGGGGGGGGGGGPGGGGGGGG
GGGGGPGGGGGGGGGGGGGGGGGGGGGGGGGPGGGGGGGG
GGGGGPGGGGGGGGGGGGGGGGGGGGGGGGGPGGGGGGGG
GGGGGPPPPPPPPPPPPPPPPPPPPPPPPPPPPPPGGGGG
GGGGGTGGGGGGGGGGGGGGGGGGGGGGGGGGGGPGGGGG
GGGGGTGGGGGGGGGGGGGGGGGGGGGGGGGGGGPGGGGG
GGGGGTGGGGGGGGGGGGGGGGGGGGGGGGGGGGPGGGGG
GPPPPPPPPPPPPGGGGGGGGGGGGGGGGGGGGGPGGGGG
GPGGGGGGGGGGPGGGGGGGGGGGGGGGGGGGGGPGGGGG
GPGGGGGGGGGGPGGGGGGGGGGGGGGGGGGGGGPGGGGG
GPPPPPPPPPPPPTTTTTTTPPPPPPPPPPPPPPPGGGGG
GGGGGGPGGGGGPGGGTGGGGGGGGGGGGGGGGGGGGGGG
GGGGGGPGGGGGPTTTTTTTPPPPPPPPPPPPPPPPPGGG
GGGGGGPGGGGGPGGGGGGGGGGGGGGGGGGGGGGGPGGG
GGGGGGPPPPPPPGGGGGGGGGGGGGGGGGGGGGGGPGGG
GGGGGGPGGGGGGGGGGGGGGGGGGGGGGGGGGGGGPGGG
GGGGGGTGGGGGGGGGGGGGGGGGGGGGGGGGGGGGPGGG
GGGGGGTGGGGGGGGGGGGGGGGGGGGGGGGGGGGGPGGG
GGGGGGTGGGGGGGGGGGGGGGGGGGGGGGGGGGGGPGGG
GGGGGGTGGGGGGGGGGGGGGGGGGGGGGGGGGGGGPGGG
GGGGGGPGGGGGGGGGGGGGGGGGGGGGGGGGGGGGPGGG
GGGGGGPPPPPPPPPPPPPPPPPPPPPPPPPPPPPPPGGG
GGGGGGGGGPGGGGGGGGGGGGGGGGGGGGGGTGGGGGGG
GGGGGGGGGPGGGGGGGGGGGGGGGGGGGGGGTGGGGGGG
GGPPPPPPPPPPPPPPPPPPGGGGGPPPPPPPPPPPPPGG
GGPGGGGGGGGGGGGGGGGPGGGGGPGGGGGGGGGGGPGG
GGPGGGGGGGGGGGGGGGGPTTTTTPGGGGGGGGGGGPGG
GGPGGGGGGGGGGGGGGGGPGGGGGPGGGGGGGGGGGPGG
GGPPPPPPTTTTTPPPPPPPGGGGGPGGGGGGGGGGGPGG
GGGGGGGGGGGGGGGGGGGGGGGGGPGGGGGGGGGGGPGG
GGGGGGGGGGGGGGGGGGGGGGGGGPPPPPPPPPPPPPGG
GGGGGGGGGGGGGGGGGGGGGGGGGGGGGGGGGGGGGGGG
GGGGGGGGGGGGGGGGGGGGGGGGGGGGGGGGGGGGGGGG