[23,33]
17
75
{Bomb,7} {Gas,10} {MaleChange,5} {FemaleChange,5} {NoEntry,10} {Poison,6} {DeathRat,26} {Sterilisation,12}
GGGGGGGGGGGGGGGGGGGGGGG
GGGGGGGGMPPPPPPGGGGGGGG
GGGGGGGGPGGGGGPGGGGGGGG
GGGGGGGGPGGGGGPGGGGGGGG
GGGPPPPPPGGGGGPPPPPPGGG
GGGTGGGGPGGGGGPGGGGTGGG
GGGTGGGGPPPPPPFGGGGTGGG
GGGTGGGGGGGTGGGGGGGTGGG
GPPPPPPPPPPPPPPPPPPPPFG
GTGGGGGGGGGGGGGGGGGGGTG
GTGGGGGGGGGGGGGGGGGGGTG
GPPPPPPPTTPTTTTTTPPPPPG
GPGGGGGGGGPGGGGGGGGGGPG
GPGGGGGGGGPGGGGGGGGGGPG
GPGGGGGGGGPGGGGGGGGGGPG
GPGGGGGGGGPGGPGGGGGGGPG
GPGGGGGGGGPGGPGGGPPPPPG
GPGGPPPPTTFPPPPTTPGGGGG
GPGGGGGPGGGGGPGGGPGGGGG
GPGGGGGPGGGGGPGGGPGGGGG
GPGGGGGPGGGGGPGGGPGGGGG
GMPPPPPPTTTTTPTTTPPPPPG
GTGGGGGGGGGGGGGGGGGGGTG
GTGGGGGGGGGGGGGGGGGGGTG
GPPPPPPPPPPPPPPPPPPPPPG
GGGTGGGGGGGPGGGGGGGTGGG
GGGTGGGGMPPPPPPGGGGTGGG
GGGTGGGGPGGGGGPGGGGTGGG
GGGPPPPPPGGGGGPPPPPPGGG
GGGGGGGGPGGGGGPGGGGGGGG
GGGGGGGGPGGGGGPGGGGGGGG
GGGGGGGGPPPPPPFGGGGGGGG
GGGGGGGGGGGGGGGGGGGGGGG
