GGGGGGGGGGGGGGGGGGGG
GPPPPPGGGGGGGGGGGGGG
GPGGGPGGGGGGGPPPPGGG
GPGGGPGGGGGGGPGGPGGG
GPPPPPPPPPPPPPPPPGGG
GPGGPGGGGGGGGPGGGGGG
GPGGPTTTTTTTTPGGGGGG
GPGGPGGGGGGGGGGGGGGG
GPPPPPPPPPPPPPPPPTGG
GGGGPGGGGGGGGGGGGTGG
GGGGPPPPPPPPGGGGGTGG
GGGGPGGGGGGPGGGGGTGG
GGGGPGGGGGGPGGGGGTGG
GPPPPGGGGGGPPPPPPTGG
GPGGPGGGGGGPGGPGGGGG
GPGGPGGGGGGPGGPGGGGG
GPPPPTTTTTTPPPPPPPPG
GGGGGGGGGGGGGGPGGGPG
GGGGGGGGGGGGGGPPPPPG
GGGGGGGGGGGGGGGGGGGG
10
12
Bomb 1 Gas 2 MaleChange 3 FemaleChange 4 NoEntry 5 Poison 6 DeathRat 7 Sterilisation 8