[20,20]
18
60
{Bomb,8} {Gas,12} {MaleChange,8} {FemaleChange,8} {NoEntry,11} {Poison,6} {DeathRat,24} {Sterilisation,14}
GGGGGGGGGGGGGGGGGGGG
GFPPPPPPPPPPPPPPPPMG
GPGGGGGGGGGGGGGGGGPG
GPGGGGGGGGGGGGGGGGPG
GPGGGGGGGGGGGGGGGGPG
GPPPPPPPPFPPPPPPPPPG
GPGGGGGGGGGGGGGGGGPG
GTGGGGGGGGGGGGGGGGTG
GTNPPPPPPPPPPPPPPKTG
GTGGGGGGGGGGGGGGGGTG
GTGGGGGGGGGGGGGGGGTG
GTTPPPPPPPPPPPPPPTTG
GTGGGGGGGGGGGGGGGGTG
GPGGGGGGGGGGGGGGGGPG
GPPPPPPPPMPPPPPPPPPG
GPGGGGGGGGGGGGGGGGPG
GPGGGGGGGGGGGGGGGGPG
GPGGGGGGGGGGGGGGGGPG
GFPPPPPPPPPPPPPPPPMG
GGGGGGGGGGGGGGGGGGGG
