GGGGGGGGGGGGGGGGGGGG
GPPPPPPTTTTTTPPPPPPG
GPGGGGGGGGGGGGGGGGPG
GPPPPPPTTTTTTPPPPPPG
GPGGGGGGGGGGGGGGGGPG
GPPPPPPTTTTTTPPPPPPG
GPGGGGGGGGGGGGGGGGPG
GPPPPPPTTTTTTPPPPPPG
GPGGGGGGGGGGGGGGGGPG
GPPPPPPTTTTTTPPPPPPG
GPPPPPPTTTTTTPPPPPPG
GPGGGGGGGGGGGGGGGGPG
GPPPPPPTTTTTTPPPPPPG
GPGGGGGGGGGGGGGGGGPG
GPPPPPPTTTTTTPPPPPPG
GPGGGGGGGGGGGGGGGGPG
GPPPPPPTTTTTTPPPPPPG
GPGGGGGGGGGGGGGGGGPG
GPPPPPPTTTTTTPPPPPPG
GGGGGGGGGGGGGGGGGGGG