[20,20]
16
80
{Bomb,10} {Gas,12} {MaleChange,8} {FemaleChange,8} {NoEntry,11} {Poison,8} {DeathRat,20} {Sterilisation,14}
GGGGGGGGGGGGGGGGGGGG
GPPPPPPPPPPPPPPPPPPG
GPGGGGGGGGGGGGGGGGPG
GPGGGGGGGGGGGGGGGGPG
GPGGGGGGGGGGGGGGGGPG
GPPPPPPPPPPPPPPPPPPG
GPGGGGGGGGGGGGGGGGPG
GTGGGGGGGGGGGGGGGGTG
GTTPPPPPPPPPPPPPPTTG
GTGGGGGGGGGGGGGGGGTG
GTGGGGGGGGGGGGGGGGTG
GTTPPPPPPPPPPPPPPTTG
GTGGGGGGGGGGGGGGGGTG
GPGGGGGGGGGGGGGGGGPG
GPPPPPPPPPPPPPPPPPPG
GPGGGGGGGGGGGGGGGGPG
GPGGGGGGGGGGGGGGGGPG
GPGGGGGGGGGGGGGGGGPG
GPPPPPPPPPPPPPPPPPPG
GGGGGGGGGGGGGGGGGGGG
