[40,40]
22
80
{Bomb,8} {Gas,10} {MaleChange,8} {FemaleChange,8} {NoEntry,12} {Poison,7} {DeathRat,22} {Sterilisation,12}
GGGGGGGGGGGGGGGGGGGGGGGGGGGGGGGGGGGGGGGG
GTTTPPPPPPPPPPPPPPMGGGGGGGGGGGGGGGGGGGGG
GTGGGGGGGGGGGGGGGGPGGGGGGGGGGGGGGGGGGGGG
GTGGGGGGGGGGGGGGGGPPPPPPPPPPPPPPPPPPPPPG
GPGGGGGGGGGGGGGGGGPGGGGGGGGGGGGGGGGGGGPG
GPGGGGGGGGGGGGGGGGPGGGGGGGGGGGGGGGGGGGPG
GFPPPPPPPPPPPPPPPPPPTTTTTTTPPPPPPPPPPPFG
GGGGGPGGGGGGGGGGGGGGGGGGGGGGGGGPGGGGGGGG
GGGGGPGGGGGGGGGGGGGGGGGGGGGGGGGPGGGGGGGG
GGGGGPGGGGGGGGGGGGGGGGGGGGGGGGGPGGGGGGGG
GGGGGFPPPPPPPPPPPPPPPPPPPPPPPPPMPPPGGGGG
GGGGGTGGGGGGGGGGGGGGGGGGGGGGGGGGGGPGGGGG
GGGGGTGGGGGGGGGGGGGGGGGGGGGGGGGGGGPGGGGG
GGGGGTGGGGGGGGGGGGGGGGGGGGGGGGGGGGPGGGGG
GPPPPPPPPPPPPGGGGGGGGGGGGGGGGGGGGGPGGGGG
GPGGGGGGGGGGPGGGGGGGGGGGGGGGGGGGGGPGGGGG
GPGGGGGGGGGGPGGGGGGGGGGGGGGGGGGGGGPGGGGG
GPPPPPPPPPPPPTTTTTTTPPPPPPPPPPPPPPPGGGGG
GGGGGGPGGGGGPGGGTGGGGGGGGGGGGGGGGGGGGGGG
GGGGGGPGGGGGPTTTTTTTPPPPPPPPPPPPPPPPPGGG
GGGGGGPGGGGGPGGGGGGGGGGGGGGGGGGGGGGGPGGG
GGGGGGPPPPPPPGGGGGGGGGGGGGGGGGGGGGGGPGGG
GGGGGGPGGGGGGGGGGGGGGGGGGGGGGGGGGGGGPGGG
GGGGGGTGGGGGGGGGGGGGGGGGGGGGGGGGGGGGPGGG
GGGGGGTGGGGGGGGGGGGGGGGGGGGGGGGGGGGGPGGG
GGGGGGTGGGGGGGGGGGGGGGGGGGGGGGGGGGGGPGGG
GGGGGGTGGGGGGGGGGGGGGGGGGGGGGGGGGGGGPGGG
GGGGGGPGGGGGGGGGGGGGGGGGGGGGGGGGGGGGPGGG
GGGGGGMPPPPPPPPPPPPPPPPPPPPPPPPPPPPPFGGG
GGGGGGGGGPGGGGGGGGGGGGGGGGGGGGGGTGGGGGGG
GGGGGGGGGPGGGGGGGGGGGGGGGGGGGGGGTGGGGGGG
GGPPPPPPPPPPPPPPPPPPGGGGGPPPPPPPPPPPPFGG
GGPGGGGGGGGGGGGGGGGPGGGGGPGGGGGGGGGGGPGG
GGPGGGGGGGGGGGGGGGGPTTTTTPGGGGGGGGGGGPGG
GGPGGGGGGGGGGGGGGGGPGGGGGPGGGGGGGGGGGPGG
GGFPPPPPTTTTTPPPPPPPGGGGGPGGGGGGGGGGGPGG
GGGGGGGGGGGGGGGGGGGGGGGGGPGGGGGGGGGGGPGG
GGGGGGGGGGGGGGGGGGGGGGGGGMPPPPPPPPPPPPGG
GGGGGGGGGGGGGGGGGGGGGGGGGGGGGGGGGGGGGGGG
GGGGGGGGGGGGGGGGGGGGGGGGGGGGGGGGGGGGGGGG