[23,33]
24
75
{Bomb,6} {Gas,10} {MaleChange,5} {FemaleChange,5} {NoEntry,10} {Poison,6} {DeathRat,14} {Sterilisation,12}
GGGGGGGGGGGGGGGGGGGGGGG
GGGGGGGGPPPPPPPGGGGGGGG
GGGGGGGGPGGGGGPGGGGGGGG
GGGGGGGGPGGGGGPGGGGGGGG
GGGPPPPPPGGGGGPPPPPPGGG
GGGTGGGGPGGGGGPGGGGTGGG
GGGTGGGGPPPPPPPGGGGTGGG
GGGTGGGGGGGTGGGGGGGTGGG
GPPPPPPPPPPPPPPPPPPPPPG
GTGGGGGGGGGGGGGGGGGGGTG
GTGGGGGGGGGGGGGGGGGGGTG
GPPPPPPPTTPTTTTTTPPPPPG
GPGGGGGGGGPGGGGGGGGGGPG
GPGGGGGGGGPGGGGGGGGGGPG
GPGGGGGGGGPGGGGGGGGGGPG
GPGGGGGGGGPGGPGGGGGGGPG
GPGGGGGGGGPGGPGGGPPPPPG
GPGGPPPPTTPPPPPTTPGGGGG
GPGGGGGPGGGGGPGGGPGGGGG
GPGGGGGPGGGGGPGGGPGGGGG
GPGGGGGPGGGGGPGGGPGGGGG
GPPPPPPPTTTTTPTTTPPPPPG
GTGGGGGGGGGGGGGGGGGGGTG
GTGGGGGGGGGGGGGGGGGGGTG
GPPPPPPPPPPPPPPPPPPPPPG
GGGTGGGGGGGPGGGGGGGTGGG
GGGTGGGGPPPPPPPGGGGTGGG
GGGTGGGGPGGGGGPGGGGTGGG
GGGPPPPPPGGGGGPPPPPPGGG
GGGGGGGGPGGGGGPGGGGGGGG
GGGGGGGGPGGGGGPGGGGGGGG
GGGGGGGGPPPPPPPGGGGGGGG
GGGGGGGGGGGGGGGGGGGGGGG
