[28,26]
24
90
{Bomb,4} {Gas,10} {MaleChange,5} {FemaleChange,5} {NoEntry,10} {Poison,9} {DeathRat,20} {Sterilisation,16}
GGGGGGGGGGGGGGGGGGGGGGGGGGGG
GGGGGGGGGGGGGGGGGGGGGGGGGGGG
GGPPPPPPPPGGGGGGGGPPPPPPPPGG
GGPGGGGGGPGGGGGGGGPGGGGGGPGG
GGPGGGGGGPGGGGGGGGPGGGGGGPGG
GGPGGGGGGPGGGGGGGGPGGGGGGPGG
GGPGGGTTTPGGGGGGGGPTTTGGGPGG
GGPGGGTGGPGGGGGGGGPGGTGGGPGG
GGPGGGTGGPGGGGGGGGPGGTGGGPGG
GGPPPPPPPPGGGGGGGGPPPPPPPPGG
GGGGGGGGGPPPPPPPPPPGGGGGGGGG
GGGGGGGGGPGTGGGGTGPGGGGGGGGG
GGGGGGGGGPGTGGGGTGPGGGGGGGGG
GGGGGGGGGPGTGGGGTGPGGGGGGGGG
GGPPPPPPPPGTGGGGTGPPPPPPPPGG
GGPGTGGTGGGTGGGGTGGGTGGTGPGG
GGPGTGGTGGGTGGGGTGGGTGGTGPGG
GGPGTGGTGGGTGGGGTGGGTGGTGPGG
GGPGTGGTGPPPPPPPPPPGTGGTGPGG
GGPGTGGTGPGGGGGGGGPGTGGTGPGG
GGPGTGGTGPGGGGGGGGPGTGGTGPGG
GGPGTGGTGPGGGGGGGGPGTGGTGPGG
GGPGTGGTGPGGGGGGGGPGTGGTGPGG
GGPPPPPPPPGGGGGGGGPPPPPPPPGG
GGGGGGGGGGGGGGGGGGGGGGGGGGGG
GGGGGGGGGGGGGGGGGGGGGGGGGGGG